1111111111111
1X000000000X1
1000000000001
100C00E00P001
1000000000001
1X000000000X1
1111111111111
