1111111111111
1E000000000C1
100000P000001
1000000000001
1111111111111
